看个电影看到一半就卡住了	质量	性能
m3的太慢了后悔没要i5的还换不了货了	售后维修	价格
pro四代还是性价比比较好	价格	整机
pro的预算	价格	整机
买pro4128g版本在我斟酌在三之后是我最好的选择新的版本没有太多提高	购买意向	操作系统
五六千块的东西	价格	其他
但说是促销	价格	销售
其他做的比微软好100倍	整机	价格
刚冲完电100%	电源电池	价格
前前后后花了近5个小时时间总算是把所有更新弄完了（家里是200M的带宽	操作系统	其他
双11没有618力度大	价格	其他
双十一打折买的	价格	其他
双十一期间连同键盘盖价格5600左右	价格	其他
坚决抵制	指代不明	购买意向
就是感觉128G小了点	存储	电源电池
幸亏有百度	其他	价格
性价比很高的笔记本二合一	价格	性能
我就算了	其他	价格
我是9号晚上10点50拍下	其他	价格
我自己花了钱的东西你不能及时给我配送就算了	快递	其他
才4加128	存储	价格
故意把原价提高太多	价格	整机
最逗比的	其他	价格
有20厘米的高度是完全空的就这样还不让开箱验货	包装	其他
果然不负我的克制（省下200而已	价格	购买意向
毕竟4G还是太小接口数实在太少	内存	价格
毕竟牌子货	品牌形象	快递
然后申请保价退钱也很快	售后维修	价格
然而开机运存占用50多很无奈	内存	价格
算是国内品牌比较划算的东西了	价格	销售
虽然只买了低配	购买意向	使用体验
虽然感觉软件bug还是有点多	软件	使用体验
趁这次有优惠果断入手	购买意向	价格
重量跟联想i230差不多	尺寸	价格
一心想用surface打王者	使用体验	整机
一斤多的重量对我来说也是满便携的用了半个月	使用体验	价格
万幸这次没有破损总之这次的购物体验相当糟糕	销售	整机
上手比较快	使用体验	性能
不用笔的话手触还是不那么灵敏	输入	使用体验
也没有感觉烫手	散热	使用体验
也需要三四个小时才能充满	电源电池	质量
交仓库备用	使用体验	性能
人家除了系统不好用	操作系统	使用体验
作为一个资深水果用户	其他	性能
使用流畅	使用体验	性能
其他使用非常流畅	使用体验	性能
其他的情况需要进一步观察	使用体验	整机
再也不用担心我的工作了强烈推荐	购买意向	使用体验
刚开始以为是自己不会用	使用体验	其他
刚才发给你那几个对对对	其他	使用体验
卖点主要是触本一体	使用体验	整机
只是个人笔用得比较少	输入	使用体验
只是使用word或者excel工作	办公软件	使用体验
只能当台式机使用	使用体验	其他
只要用的没问题	使用体验	质量
各种小贴心	使用体验	整机
因为体验会有质的飞跃刚开始用的时候经常会跳屏	屏幕	质量
在正常使用中看不出来	其他	使用体验
外出临时画cad图只要一支笔加手触已经可以替代鼠标操作了	输入	使用体验
好不容易找到软件	程序应用	机身
小巧轻便适合移动办公	使用体验	尺寸
就显示才能用3个多小时真怀疑是不是被用过的哦	电源电池	屏幕
尽管我此刻的评论是复制粘贴的这一方面是为了肯定商家的服务	销售	使用体验
己经习惯了	使用体验	其他
希望能用起来给力物流十一并不理想	使用体验	其他
平板使用也就3至4次	使用体验	其他
平板模式看电影	使用体验	性能
开会演示使用	使用体验	其他
开心w	使用体验	整机
当然	其他	使用体验
很怀疑是别人拆过用了的	使用体验	其他
心仪已久的电脑键盘安装简单	使用体验	购买意向
把劳资吓坏了啊来说说手感	其他	使用体验
抱着12寸看东西确实不如8寸来的舒服	尺寸	使用体验
拿到手后感觉轻飘飘的没有ipad厚实	尺寸	输入
拿来笔就不能正常使用	输入	使用体验
最主要的看重的是便携	使用体验	尺寸
有时候不方便收件的时候	其他	性能
有时候不方便收件的时候	其他	性能
比予想的看起来好很多	使用体验	整机
熟悉的界面	使用体验	其他
用一段后补评外面包装太差	包装	使用体验
用了两个多月出现花屏和小白斑	屏幕	使用体验
用了几天还可以笔也很好用呀	输入	使用体验
电脑都打不开了起码你让我可以用到电脑基本功能啊买来就是为了办公方便打给客服	售后维修	使用体验
目前唯一发现的缺点是显示屏和背面LOGO容易沾上灰尘	使用体验	指代不明
目前我还没去查我的机子还剩多少天保修	售后维修	使用体验
纤纤显示器感觉也很舒服	显卡	输入
结果现在只能沦为儿子看动画片专用	其他	性能
脑子一热买了个128G的后悔死	购买意向	其他
记笔记	使用体验	整机
试用试用再说	使用体验	其他
说好的能用十个小时呢两三个小时差不多	电源电池	使用体验
调用一个word简直等很久售后也联系不上	使用体验	其他
轻办公用着方便值得购买	使用体验	购买意向
这两天用着就没那么热了	散热	使用体验
这个套装版还有什么意义	使用体验	指代不明
配合微软的系统也适合自己的操作习惯	使用体验	操作系统
配合触控笔简直不要太方便	输入	使用体验
需要长按开机键和音量键安全启动	使用体验	其他
领导来检查用起来非常的方便快捷	使用体验	性能
10月30号报修到现在都没有什么音讯	售后维修	其他
11早上一看又变成12号送达客服人员还非常霸气得狡辩没有改送达时间可惜我没有截图保存证据东哥	快递	其他
3小时左右吧待机也就一晚	电源电池	其他
8或9个小时应该还是能撑过的本子	电源电池	其他
一个月	其他	价格
一回家就连了网	网络通信	其他
一天没审核自己去买了电池装上好了整体购物体验负分差评	其他	整机
一直显示下放二	其他	购买意向
丁烦烦烦探讨探讨探讨探讨	其他	散热
不然直接送人家不是闹了个大笑话现在笔又要等两天售后安排上门取走然后再等七到十五天才能换给我	售后维修	其他
不用到处选择发货速度快节约了我上街的时间	快递	其他
不能分区	存储	指代不明
两手分别都出现了10来个小红疙瘩	其他	使用体验
两次蓝屏的UWP应用并非同一个一个是搜狐	屏幕	质量
为什么一定要打字	其他	整机
主要拿来Office办公用	办公软件	性能
之前看到很多负面的评价	整机	价格
之后好多了	整机	使用体验
也是悲剧了	其他	质量
买来学习	其他	使用体验
买来纯办公用	其他	使用体验
买这个主要是用来用onenote做笔记的	办公软件	其他
从Win8就一直存在	操作系统	其他
从仓储管理	其他	整机
从仓储管理	其他	整机
以解客户忧患	其他	销售
以解客户忧患	其他	销售
会经常跑	其他	整体外观
但是不是我的	其他	指代不明
但是你搜索东西跳转到第二个页面就出问题了刚买来的时候也是这样申请了维修	其他	购买意向
但是现在已经无限重启了	其他	质量
但是目前为止	其他	指代不明
其他的只能说是超大屏手机使用了一个星期才来评价	其他	整机
卸载	其他	网络通信
厉害了	整机	其他
又打售后说配件硬件问题会给我换但是要等七到十五天	售后维修	其他
反正我同事说够我用的了	使用体验	其他
同时买的小米	其他	购买意向
售后给我讲操作了一连串的数字	售后维修	其他
唯一不足的是我以前机器上的蓝牙鼠标无法使用	输入	其他
喜欢的赶快入手哦	购买意向	其他
因为周围用ipad的太多了	其他	整机
在客服May的帮助下	售后维修	其他
多次承诺送货多次食言	快递	购买意向
好没有用朋友推荐	其他	购买意向
如果要给我配送的话还要向上级反应	销售	其他
小激动	其他	性能
少一个星是因为	其他	指代不明
就再也不理我了	其他	购买意向
就是没有礼品送	其他	快递
就是没有礼品送	其他	快递
就是没有送膜什么的	其他	指代不明
就算用触控笔也一样升级之后就几乎完全没有了	输入	使用体验
居然是重复闪退崩溃的	性能	售后维修
已安装上CAD	软件	其他
希望你能彻查此事	其他	质量
帮朋友买了	其他	购买意向
幸亏没丢件	快递	价格
微信推文什么的	其他	品牌形象
微软平板做的真是没话说	整机	其他
感觉真的是打开了新世界的大门	其他	操作系统
我买个机子	购买意向	其他
我买了电脑回来还要我自己设置系统你们是干嘛的那我花钱干嘛呢电话指导维修了	售后维修	其他
我的工作用autocad比较多	其他	价格
所以经常玩游戏的话最好还是买厚一些	其他	整机
拿去给懂的朋友看	其他	整体外观
换新速度挺快的然而后面不小心划了怕是有问题也不能再换了评价一下机器	质量	性能
搞活动买的	其他	价格
早用早享受	其他	使用体验
昨晚电脑奔溃	整机	其他
最后可怜兮兮的显示一个错误代码要我联系技术支援部门对了国庆假期支援部门还不上班呢	整机	其他
期间升级win10系统N次直到最新版还是显示蓝牙鼠标已连接	输入	质量
本来就是买来给宝宝学英语用	其他	使用体验
机器运行很顺畅目前还在使用中	其他	整机
正在系统升级可是我的发票不知道为啥没到	销售	快递
没有任何填充物	包装	其他
没用过别的牌子的这种电脑	使用体验	其他
没的说安装CAD遇到麻烦	软件	指代不明
然后开机键音量键手指轻放上去会四周晃动特别松动然后背后支架也是掰开松紧度不统一松一下紧一下	质量	其他
照片都还是我擦过以后的样子箱子里面居然没有任何的填充物	包装	其他
现在评价感觉吧	其他	整机
用了10几分钟就很热很热了厂家售后挺好的	散热	售后维修
用了一个月	其他	使用体验
用了大概三个星期才来评价	其他	使用体验
用了好久才来评价的	其他	使用体验
用手机新注册的账号	其他	购买意向
用的好在追评	其他	使用体验
电脑还要慢慢试	其他	整机
留意了一整个月了三个1出手的111	其他	价格
目前拿来记笔记看paper	其他	整机
目前的显卡驱动和win10系统之间存在BUG	显卡	其他
看多了IPAD	其他	性能
神器呀办公娱乐两不误双11	性能	其他
第二天一早肯定要充电PS	电源电池	其他
等到1111	其他	价格
给女儿买的生日礼物	其他	购买意向
网上说的问题都没有	其他	质量
老婆看上的轻巧本本	其他	整机
老板指定的机型	其他	整机
胶带都开了忘记拍照了	质量	其他
莫非要你让人家跳河）（热情和克制	其他	使用体验
虽然是老款	其他	价格
要把画质调低才能保持帧率还下载了个模拟器以最高画质（没有开高清模式）玩了下	其他	使用体验
让直接打微软的客服自己解决	售后维修	其他
说什么建议买8g的呀	购买意向	其他
谁要	其他	整机
跑了好多地方	其他	使用体验
还是不能在应用商店下载东西	程序应用	其他
还是挺有用和逼格的（怕手指脏	品牌形象	其他
还是易碎的电子产品的	其他	质量
还有一个最大的问题就是屏幕在选择成自动调节或者联系亮度以下亮度的情况下	屏幕	质量
还有你下ps	其他	购买意向
还烫手除了装X	散热	购买意向
还能省下买触控板的钱和减少外设附件毕竟这货只有一个	其他	整机
这也不是什么缺陷总体来说值得拥有上班用	其他	购买意向
这样我就不用去那啥拼双十一了呀	其他	使用体验
连进个打牌的游戏都很慢想配个dock	其他	性能
附带正版注册的学生版office缺点是有时取下键盘再接上时不能识别	办公软件	识别系统
非常感谢送货小哥热情	快递	销售
非常适合黄油涂鸦做笔记码字	整机	使用体验
首先	其他	购买意向
首先外观没话说	整体外观	其他
电脑和谷歌浏览器十分不兼容	兼容性	整机
4G有点小	内存	尺寸
已缓存的	其他	内存
一不小心就抢到了套装	包装	购买意向
一个是只装腾讯	其他	包装
不过无损内涵和环保隔天才打开的	包装	质量
京东包装有点迷	包装	销售
但好几千的东西不能用箱子装吗	包装	整机
你丫的能不能弄个好点箱子	包装	其他
木有任何减震措施	包装	使用体验
送过来时外壳都坏掉了	包装	质量
钢化膜	包装	品牌形象
银子不够无奈接受追加了ARC和软甲护壳（外观比起裸机的透气变得硬朗）	包装	购买意向
但是微软中国的服务是杠杠滴	品牌形象	销售
但是微软的surface系列好像都有充电发热的情况	散热	质量
大家自己去注册微软可以保2年	品牌形象	购买意向
好用大品牌	品牌形象	使用体验
微软我是没用过他们的产品	品牌形象	其他
感觉很奇怪	品牌形象	指代不明
才来评价和微软官方确认正品	品牌形象	整机
新款只不过CPU稍微高点	CPU	品牌形象
磁吸都感受到其散发的逼格	品牌形象	使用体验
科技感很强	品牌形象	使用体验
取消了退货申请	售后维修	其他
我已经把这电热砧板退了	售后维修	其他
提案	售后维修	性能
不要只被外表吸引	其他	质量
作为平板稍嫌大了点	尺寸	整机
字非常小	尺寸	程序应用
累	使用体验	价格
重点要夸一下快递员	快递	尺寸
12寸屏刚好	屏幕	快递
显卡性能有点差	显卡	性能
有背灯	屏幕	其他
虽然第一个有闪屏	屏幕	质量
视频清晰	屏幕	性能
今天中午收到货机子刚用	快递	其他
到手了	快递	其他
各种找不到	快递	整机
态度很愉快	快递	性能
昨天下单	快递	价格
毕竟手机都4g主流了	其他	性能
配送员也非常的热情	快递	其他
配送员也非常的热情	快递	其他
CPU性能最强	CPU	性能
一个是追影电源适配器	电源电池	性能
三的图界面	程序应用	性能
上手快	性能	其他
上网速度不够快	性能	网络通信
不怎么影响	性能	使用体验
不敢想象如果网络速度不够要画多久时间才能开始使用）	网络通信	性能
不能安装Photoshop和Lightroom这两个我离不开的软件	软件	办公软件
不能用天正cad有点麻烦	软件	指代不明
东西很好速度很快	性能	快递
也很快捷	其他	性能
书写流畅（看pdf没有很好用的软件	性能	输入
但如果用于做ppt	其他	性能
但是系统很流畅	操作系统	性能
作为第二电脑来说够用了	性能	其他
你就是运行软件	程序应用	品牌形象
值慢慢开用了	其他	性能
冬天还可以用	性能	使用体验
办公用足够只是对有些软件的支持和优化还不到位	性能	使用体验
升完级就没法刷脸了	性能	识别系统
双十一的速度实在是不能恭维	快递	其他
只是外出办公用觉得还行	性能	使用体验
可能是因为升级系统的关系	性能	操作系统
和一些简单上网看电影的话	其他	性能
因为我已横向纵向/实体和网店	其他	销售
因为确实功能有点少	性能	操作系统
在浏览器栏输入地址会直接卡死	浏览器	性能
基本所有的办公用品都是得力	性能	使用体验
太好用了速度超快	性能	使用体验
如图	其他	指代不明
如网易云音乐之类的	软件	性能
娱乐就慢慢再体会了	性能	其他
小的根本不够用	性能	使用体验
就是感觉4G的反应有点慢	性能	使用体验
希望上网速度也快	网络通信	性能
平时用来办公	性能	使用体验
开机完成一系列的注册	性能	其他
开机时	性能	质量
性能后期操作后在追加评论	性能	其他
总感觉内存会不够用	内存	使用体验
感觉不错面部识别不是太灵敏	识别系统	性能
我不玩游戏也不用这个看电影主要是用来码字也够用了	性能	使用体验
战战兢兢的打开	性能	质量
所以性能还是很好	性能	整机
携带很方便pro4的反应速度也很快	性能	使用体验
操作界面的字太小了	程序应用	性能
出现过一次开机闪屏和杂音	屏幕	质量
效率很高	性能	使用体验
数次调戏进度条	其他	输入
是因为开机时间长你一直运行	性能	其他
机器就放一箱子里没有任何填充缓冲物	包装	其他
机身温度也不高	散热	性能
每次退出就自动刷新界面	性能	屏幕
比自己去店里买都快	快递	其他
没想到这机子反应也太慢了	性能	整机
玩点小游戏也听惬意缺点也很多	性能	质量
现在都是可以调节角度的后座	性能	售后维修
直接能打开	其他	质量
看电影	其他	电源电池
看网页和打字还会卡一下是什么情况	性能	质量
笔可玩性比较高	性能	输入
系统流畅	操作系统	性能
系统流畅	操作系统	性能
系统流畅	操作系统	性能
系统运行也流畅	操作系统	性能
网易云音乐之类常用聊天X86应用	程序应用	性能
网速很快	网络通信	性能
考虑到办公需要就入手这台Surface刚开机设置之后发现WiFi的驱动异常	性能	其他
还是专业版更好希望能用久点	操作系统	性能
还是用来修图比较能够发挥最大潜能	性能	其他
这功能对我用处不大	性能	使用体验
这效率	性能	使用体验
配合onenote笔记神器	办公软件	性能
除了心情别的不影响不过	性能	使用体验
音亮滑一滑不了还有这些上下滑反页也不行例如酷狗搜索歌曲之后	程序应用	性能
一百次都不嫌麻烦风扇声特别大	散热	购买意向
为什么	其他	指代不明
之前说是软件更新的事	程序应用	指代不明
省心	指代不明	使用体验
amazing	整机	操作系统
ipad简直就是平板玩具最后onenote+笔还在体验中	办公软件	其他
webex等软件字体大小尝试N种办法都不行	程序应用	操作系统
不是全新啊	质量	销售
只不过刚到手的机器一定要先把系统升级到最新版	操作系统	质量
在家找出多年没用用过的usb网卡（幸好这东东有个usb口）继续更新系统	操作系统	其他
就是上的i5乞丐版	CPU	操作系统
有点不习惯win10	操作系统	价格
系统也很流畅	操作系统	性能
系统默认好评	其他	操作系统
过关）	其他	购买意向
唯一觉得有点遗憾的是发热问题	散热	质量
平板状态玩纸牌都起热	散热	使用体验
很容易发烫另外电池简直太差了啊	散热	整机
有评价说散热不好	散热	整机
确实存在散热不好的问题	散热	整机
确实有点烫手	散热	使用体验
风扇只启动过一次很吓人	散热	指代不明
不错的产品设计	整体外观	整机
主要竞争力没有发挥优势没有太惊艳	整体外观	使用体验
就那样	整体外观	指代不明
工艺还不错吧	整体外观	整机
很美妙的感觉）物流给力次日达	快递	整体外观
无法启动相机不好使有很多不方便之处但是我非常喜欢这款的设计	整体外观	使用体验
最严重的是经常出现开机屏幕不亮	屏幕	质量
本体侧面有轻微的划痕	整体外观	使用体验
机器外观挺不错的	整体外观	整机
看中这款本子	整体外观	购买意向
看着跟理想的区别不大就是笔还没玩	整体外观	整机
看起来很不错	整体外观	整机
简直就是鸡肋	整机	其他
设置这	其他	指代不明
设置那的	其他	指代不明
通过接口处的划痕可见	整体外观	质量
4g内存用来做ps和简单的cad处理也是完全没有问题	内存	质量
5颗星已经不能表达我的满意了	整机	其他
S	其他	整机
c口就很好了	IO接口	整机
new在性能上好像差别不是很多ps	性能	整机
nnd更新把无线网卡更新没了	网络通信	操作系统
一万个差评可以说是非常差了刚买来电池就是烧坏的	电源电池	购买意向
一开箱就乐不释手	整机	使用体验
一直想体验一下微软官方的产品	整机	使用体验
不支持七天退换货就寄来一台旧电脑	售后维修	其他
不是ipad	整机	性能
不晓得是不是因为我还没掌握好	使用体验	整机
不管有没有重装	质量	整机
不过单独运行CAD2016及Creo40也可	软件	价格
不过总体来说	其他	整机
东西还不错希望能够使用时间长一点呵呵	整机	其他
为了便携买的这个电脑	使用体验	其他
也安排时间另行配送同时京东商城在售后管理上也非常好的	售后维修	整机
二合一	整机	使用体验
产品还没有打开	整机	质量
从平板的角度讲	整机	性能
但是作为本子	整机	其他
但是可以自己去网页上下载分区只有一个C区	整机	其他
但是非常建议大家买一个碎屏险	整机	销售
作好了收货时的心理准备价格我十分自信	整机	其他
儿子喜欢就行了屏幕不大	屏幕	散热
先说优点	其他	使用体验
先这样吧	整机	其他
全没了	其他	整机
其它如INK工作	整机	使用体验
其实它只是有着平板外表的手提电脑运行	整机	使用体验
其实没什么影响	整机	使用体验
再也不用等三天了拆开苏菲简直就是艺术品太美了	整机	使用体验
到时候补个外接扩展总体而言秒杀价超级赞	整机	价格
到目前使用没毛病	整机	使用体验
十颗星预装office是另售的	办公软件	整机
卡的问题我就不说了	性能	质量
只看paper记笔记的话六个小时吧大概	整机	输入
可以完美运行cad非常不错	性能	整机
可以手写	输入	整机
可最后还是选择了这款今天用了一天觉得很不错	整机	使用体验
同样是i5	整机	价格
哈哈哈差点搞出不能上网的插曲客服真不错	网络通信	整机
唯一美中不足就是开机即升级	整机	销售
在苹果和这中间纠结了一个月最后还是选择这款身边人用的也比较多到手后确实不错	整机	使用体验
外貌不错女朋友很喜欢	整体外观	整机
太赞了~就是配件太贵~	价格	整机
女儿选的	其他	使用体验
好评666	整机	价格
好评尤其是脸部识别	识别系统	整机
家用都可以	整机	使用体验
京东的服务也很赞秒送	快递	销售
对着一台没有网络Windows的平板一头雾水呀	网络通信	其他
小问题就是高分辨率软件适配不太好	屏幕	尺寸
就好像刷新度低的那种感觉很不好	整机	屏幕
就是触控离苹果还差一些	输入	使用体验
就觉得只有SURFACE放在那里是个好东西	整机	品牌形象
差了点小插曲	整机	尺寸
已经离不开了一刚巨硬大法好	整机	其他
希望后期体验不会让我失望	使用体验	整机
平板是不错就是微软有些软件设计的太糟糕驱动完之后	软件	整机
很不错支持京东	整机	销售
很多人跟我一样有很多问题	整机	质量
很强大	整机	性能
微软的这款才能称之为平板电脑	整机	其他
感觉散热比普通笔记本还是差一点	整机	使用体验
感觉特别不好	整机	使用体验
感觉还行	整机	使用体验
我也不懂这些电脑啥的	整机	其他
我对微软非常失望	整机	品牌形象
我对这个微软的非常失望	整机	品牌形象
所以产品定位其实有点模糊	整机	使用体验
所以卡顿问题应该是某些软件自身问题	性能	质量
所以大家就当作是产品质量合格的意思来看就行了	整机	其他
拿到手的时候机器是完全没电的	电源电池	其他
挺实用的一款机器	整机	使用体验
效果还可以	整机	使用体验
效果还可以	整机	使用体验
敲机棒	整机	质量
无其他操作）	整机	性能
无论是作为平板还是笔记本	整机	性能
昨天下单今天就到了还没认真的试应该不错的	快递	价格
暂时还没有发现什么问题	整机	质量
最后一句	其他	整机
有一些瑕疵	整机	质量
本以为还得对着卡槽费点儿劲儿	整机	使用体验
机子不错性价比也不错	价格	整机
正好碰到秒杀	整机	使用体验
正好赶上降价女儿挺喜欢的	价格	整机
比如关机后无法开机	质量	整机
比如注册时输错一个字母一直改不过来	输入	整机
比如美图秀秀	其他	整机
毛病也不少	整机	质量
没一会儿	整机	指代不明
没人联系	其他	使用体验
没有outlook	软件	整机
没有什么问题	整机	质量
没有破损	质量	包装
没有说明书写得那样长	整机	性能
油渍	包装	整机
现在五千大洋能买到这样的电脑啊	整机	其他
用了还可以	整机	使用体验
电脑也比较卡顿	性能	整机
电脑包一个都没得送	销售	整机
电脑并不是很好用	整机	使用体验
电脑很好用	整机	使用体验
电脑很好用	整机	使用体验
电脑很漂亮	整体外观	整机
电脑很漂亮	整体外观	整机
电脑很美观很实用	整体外观	整机
电脑收到硬件应该没问题	硬件	整机
电脑用着不错	整机	使用体验
目前也没有出现睡死现象至于以后怎样	整机	使用体验
目前没有发现差评里的那些情况	质量	使用体验
相对于其他品牌二合一来说	整机	其他
相比华为e来说	其他	整机
看了其他牌子的二合一电脑	整机	其他
看着还是很不错的	整体外观	整机
看起来不错的产品	整体外观	整机
真的对得起我的期待	整机	其他
真的是一款非常好用的平板	整机	使用体验
红红火火恍恍惚惚h	其他	整机
结果还是这样	其他	整机
能有个type	IO接口	整机
苏菲真的很美	整体外观	整机
营造家庭Windows系统环境电脑	操作系统	其他
虽然不是最新的s	整机	操作系统
表示我对产品是认可的	整机	销售
觉得很多东西不兼容	整机	品牌形象
觉得麻烦	整机	指代不明
触控笔加onenote和xodo绝配	输入	整机
让加付money升级成几年免费维修	销售	价格
说真的只能给8分	整机	其他
跑eda软件这一点就可以甩ipad几条街了	整机	办公软件
跟厉害	整机	其他
运气好	整机	性能
还可以当电脑用	整机	使用体验
还好我不常玩	整机	使用体验
还没下ps	其他	整机
还烫得像铁板那样	散热	指代不明
这个也是选择这款的原因之一	整机	指代不明
这是唯一的遗憾	整机	指代不明
这样一比	整机	指代不明
连了个无线鼠标就没了电池可以	整机	质量
选择8g的话应该就好很多了	内存	使用体验
非常可气不负责的售后整整一个月都在糟心京东一生黑	整机	品牌形象
顺着指引就走向注册之路不就是一台触屏版的笔记本吗高分辨率的惊艳感不太强	整机	使用体验
pro能比的不足之处是续航太短	电源电池	整机
充电器的设计很赞	整体外观	整机
及时	其他	电源电池
只是发货的时候少了一个电源线	销售	电源电池
可惜没电的不是应该出场有点电的吗	电源电池	整机
后来我意识到可能是底电量	电源电池	质量
就是新机彻底没电比较那啥	电源电池	性能
平板这边冲一秒电	电源电池	性能
现在也就四个小时	电源电池	质量
电脑买来的时候有明显的划痕	质量	整机
看中续航时间的不要买jd	电源电池	购买意向
试了一下居然不能用于手机充电	电源电池	使用体验
说是很明显的翻新机还告诉我京东很多电子产品都是翻新机要求退款的时候	质量	其他
调到省电模式续航很长	电源电池	快递
运行了五个多小时	电源电池	使用体验
这点电池续航时间不满意收货的时候外包装是完整的	电源电池	整机
但是软件有问题	程序应用	质量
显示未安装	程序应用	屏幕
玩游戏还是别指望了	性能	识别系统
虽然因为office没激活开始出了点小插曲	办公软件	输入
语音指示省去不少搜索输入	识别系统	整机
不到一个月键盘又出现问题	输入	质量
不过为了工作也只能用这了	使用体验	质量
主要是物流问题	快递	质量
之前买台式机硬件问题	硬件	质量
之前顾虑巨硬品控	品牌形象	输入
会出现闪屏的现象	屏幕	质量
但就是	其他	指代不明
但是	其他	指代不明
但是开箱就发现崩了个豁口	质量	包装
但是本本好像很容易发热死机	散热	质量
做做表格弄弄文档很不错	质量	整机
做屁屁踢的	质量	其他
做工100	质量	价格
出现这种问题直接返厂	质量	指代不明
只是用了没一个月就掉漆了	质量	使用体验
存储有点少其他测试待定	质量	使用体验
就是显示屏两个月不到出现了问题	质量	屏幕
工作效率提高很多	质量	性能
才用了不到一个月就各种发热死机	散热	质量
打开后开关处有一个小磕碰	质量	其他
接口减少已经当主力机了	IO接口	质量
暂时还没发现啥大问题	质量	整机
期待更新之后能减轻发热的问题	散热	质量
每次用的时候都会引起同事围观	整机	使用体验
没打开	质量	其他
现象消失	质量	屏幕
目前没有存在卡顿的情况	性能	质量
确实有开不开机的情况	质量	使用体验
第一次开机电脑无法搜索任何网路信号然后技术支持帮忙解决了说不是硬件问题	网络通信	质量
第二天上午就到了不得不为京东的快递点个赞机器用起来暂时没有别人说的屏幕的问题	屏幕	质量
软件坏掉两次	程序应用	质量
548入手	价格	购买意向
9月买的	购买意向	价格
一星都不想给买了一个月	其他	购买意向
一步到位	性能	整机
一直显示这个	屏幕	购买意向
之前看了网友各种提醒贴	使用体验	其他
买之前一定要想好	购买意向	整机
买了一个月	购买意向	价格
买了一个月	购买意向	价格
买了个低配	购买意向	价格
买完后就接到推销电话	购买意向	销售
买来送外国友人	购买意向	其他
买这玩意纯属钱多	购买意向	价格
会经常光顾这家店	购买意向	销售
关键这个电脑我是送人的幸亏我检查一下准备帮人把软件都装好送人	使用体验	购买意向
十次八次	购买意向	质量
在微软实体店体验好了才来下单的	购买意向	其他
弄了好几次	指代不明	质量
心情不好买台surface安慰一下	购买意向	其他
我靠这次就被忽悠了	购买意向	其他
救场了	其他	购买意向
昨天买的	购买意向	价格
最后只是教我备份重装系统看了网上	购买意向	销售
此次破例	购买意向	整机
然后半小时不到立马退了100回来	购买意向	价格
然后有30天价保看外观没有二手痕迹	购买意向	价格
直到看到这款	购买意向	快递
第一次网购此类产品	购买意向	其他
终于完成了系统的更新和注册	购买意向	操作系统
终于降价入手没有问题	购买意向	质量
能买大一点就买大一点的吧	购买意向	整机
被强大的物流炸毛了昨晚下单	快递	购买意向
证实是多虑了	购买意向	销售
跟ipadpro比较了很久才下定决心买这款	购买意向	整机
还是加点钱买苹果的吧	购买意向	整机
这个是帮同事买的	购买意向	其他
这个本子从买到手就一直卡	购买意向	其他
这是我10月2日买的	购买意向	价格
这是我第一次在京东上买电子产品但是我觉得京东的这个买平板送键盘的这个活动也是鸡肋的很	销售	价格
这是第二台	购买意向	其他
这是第二台了	购买意向	其他
这次买这个又是到手上边框有点翘边我给摁进去有咔一声响第二天又有点翘起来了	质量	其他
个人运气太好遇到拿回来的充电线就是坏的	质量	使用体验
但是总算是少了一些有键盘盖有笔有笔尖很不错了~键盘盖没有味道~	输入	价格
再一个就是键盘还没到机子很漂亮	输入	整体外观
写写画画的比较方便（ipad	输入	性能
因为键盘明明就是顾客花了钱买的	输入	购买意向
图标闪烁	输入	性能
很方便的键盘设计	输入	使用体验
微软的让下载surface恢复映像	输入	其他
手写是亮点	输入	整体外观
新机怎么触控笔不能用	输入	质量
标压i5	CPU	价格
磨坏裸屏）或许有什么隐藏功能未用到黑色键盘银色笔	输入	屏幕
笔对我的作用不太大	输入	使用体验
触屏笔用了不到三个月不能启动inn功能	输入	屏幕
这个pro4i5-4并没感觉慢	输入	使用体验
黑色键盘比其他颜色看起来弱点	输入	整体外观
一直还是比较相信京东的	销售	品牌形象
专门等我下去收货	销售	快递
主要为京东售后打call服务太棒了	销售	整机
京东的产品信得过	销售	品牌形象
京东的速度就是快机子比iPad稍微大一点	销售	快递
客服一直很耐心解答我的问题	销售	售后维修
家里买东西基本都在京东商城里买质量有保证还足不出户	质量	销售
很商务	指代不明	销售
怀疑是旧机翻新	整机	质量
我打电话到客服部	销售	其他
打了好多电话	销售	电源电池
服了	指代不明	销售
而且微软的客服真心专业	销售	性能
联系了2天也没有处理反馈	销售	其他
行货不错京东买东西的好处就是放心	销售	整机
购买最多的产品	购买意向	销售
