pro4持有顾虑的一次澄清使用一周以来	中性	正面
一个是追影电源适配器	中性	正面
一天没审核自己去买了电池装上好了	中性	正面
一心想用surface打王者	中性	负面
七天前到的Surfacepro4以及一众大大小小的配件	中性	正面
不建议办公用	中性	负面
不懂得还问了客服	中性	正面
不是我用	中性	负面
不是我用不清楚	中性	负面
不清楚	中性	负面
不过后面用习惯了就好了	负面	中性
东西收到	中性	正面
中华民族繁荣昌盛	中性	正面
为了便携买的这个电脑	中性	正面
之前说是软件更新的事	中性	正面
之前顾虑巨硬品控	中性	正面
买商品就买京东自营	正面	中性
买除了苹果以外其他的品牌	中性	正面
二合一	中性	正面
产品还没有打开	中性	正面
京东的产品信得过	中性	正面
今天收到	中性	正面
他让我申请价保	中性	负面
以后还会遇到	中性	正面
会经常跑	中性	负面
估计只能用来看看文献和学习了pro4用着也还凑合	中性	正面
估计商家至少还赚去六七百	中性	负面
但如果用于做ppt	中性	正面
但是不是我的	中性	负面
作为经常出差的人	中性	负面
值慢慢开用了	中性	负面
做屁屁踢的	中性	正面
像是刚刚打包的一样	中性	负面
全没了	中性	正面
其实不是	中性	负面
其实它只是有着平板外表的手提电脑运行	中性	负面
具体性能还有待实验	中性	正面
再试几次解决	中性	正面
刚买得不到十五天	中性	负面
刚冲完电100%	中性	负面
刚开始以为是自己不会用	中性	负面
刚才发给你那几个对对对	中性	负面
刚收到就迫不及待的打开了	中性	负面
到手了	中性	正面
十颗星预装office是另售的	中性	负面
又回滚回来了	中性	正面
双11没有618力度大	中性	正面
反正也不是用来重度使用的	中性	负面
发现需要	中性	负面
取消了退货申请	中性	负面
可能等的太久	中性	正面
同时买的小米	中性	负面
同样是i5	中性	负面
因为周围用ipad的太多了	中性	负面
在家还可以看祝频	中性	正面
在正常使用中看不出来	中性	负面
宁错杀勿放过	中性	正面
实际就4小时	中性	负面
少一个星是因为	中性	正面
就是还没开用	中性	负面
就算用触控笔也一样	中性	正面
差了点小插曲	中性	负面
希望老用户多优惠	中性	正面
幸亏有百度	负面	正面
建议入手内存大的	中性	负面
建议如果没有绘画需求的话没有必要买笔	中性	负面
建议贴个膜吧	中性	负面
当天下单	中性	负面
微软我是没用过他们的产品	中性	正面
微软的让下载surface恢复映像	中性	负面
心情不好买台surface安慰一下	中性	负面
总体来说	中性	正面
想买很久了	中性	正面
感觉很奇怪	中性	负面
我打电话到客服部	中性	正面
战战兢兢的打开	中性	正面
所以很纠结	中性	正面
打开包装的第一感觉	中性	正面
拿来笔就不能正常使用	中性	负面
提案	中性	正面
提示系统更新	中性	正面
昨天下单	中性	正面
昨天中午收到货	中性	正面
昨晚电脑奔溃	负面	中性
是因为开机时间长你一直运行	中性	正面
是因为系统及office正版	中性	正面
暂时就这些感受	中性	负面
最后一句	中性	负面
最后还是选择了Surface	中性	正面
最后选了京东	中性	正面
本本收到了	中性	正面
本来只想买台三千多的iPad	中性	负面
机器还是要有个键盘才完整	中性	正面
正在等待解决	中性	正面
比如美图秀秀	中性	正面
没习惯差评	中性	负面
没打开	中性	正面
没话说优点和缺点都是共通的	中性	负面
添置了一张64Gsd卡	中性	负面
激动	中性	正面
现在电池消耗完后	中性	负面
用完才知道有没有效果	中性	负面
用手机新注册的账号	中性	正面
用的好在追评	中性	正面
由于要开化腾/微信/旺旺/EXCEL	中性	正面
电池不是传说中的	中性	负面
电池使用如纯上网浏览网页预计	中性	负面
电脑还要慢慢试	中性	负面
直接说返厂维修	中性	负面
看中这款本子	中性	正面
看了其他牌子的二合一电脑	中性	正面
看多了IPAD	中性	负面
看看视频和编辑文档之类的	中性	正面
码了四百字全方面体验的良心评价	中性	正面
第二次买surface	正面	中性
等到以后再换好的吧	中性	正面
纠结好久了	中性	正面
红红火火恍恍惚惚	中性	正面
终于买了	中性	正面
终于买了	中性	正面
结果随便一对	中性	正面
网易云音乐之类常用聊天X86应用	中性	负面
老板指定的机型	中性	正面
老爸评价浪费	负面	中性
而不是程序	中性	负面
联系客服说最好用自带浏览器	中性	正面
苏菲竟然两个价	中性	正面
虽4G内存	中性	负面
视频界面手动滑快进	中性	负面
触摸板的手势功能和pac基本一样（可能是很久没有用过windows）	中性	正面
让加付money升级成几年免费维修	中性	负面
设置这	中性	负面
设置那的	中性	负面
设计之初应该是为了装文件	中性	正面
说ps字小因为分辨率	中性	正面
购买第二台surface	正面	中性
跑eda软件这一点就可以甩ipad几条街了	中性	正面
跟京东客服问	中性	正面
跟笔记本一样	中性	正面
还是surface最适合轻办公+轻娱乐	中性	正面
还被以一种送给我的态度	中性	正面
还说没货	中性	负面
这两天用UWP视频APP看剧	中性	负面
这个套装版还有什么意义	中性	正面
这个我是用来玩文档	中性	正面
这效率	中性	正面
这是个什么鬼最后在我每天一个电话的询问下	中性	负面
这样一比	中性	负面
这种大额货物送货的时候尽量本人签收	中性	正面
这部电脑虽然是平板的外形	中性	正面
这里再推给那里	中性	正面
连了个无线鼠标就没了	中性	负面
连接上后断断续续的	中性	正面
连进个打牌的游戏都很慢想配个dock	中性	正面
那个笔真的	中性	负面
那系统怎么会出来这些呢	中性	负面
都说surface	中性	正面
配合相关的应用	中性	正面
配置基本一样	中性	正面
铰链	中性	正面
键盘单独包装的	中性	负面
预算足建议还是买8g内存	中性	正面
8或9个小时应该还是能撑过的本子作为第二电脑来说够用了	正面	中性
pro4自己断wifi这个功能也是6	正面	中性
win10系统好用还预装了Office2016	正面	中性
一开箱就乐不释手	正面	负面
一斤多的重量对我来说也是满便携的用了半个月	正面	中性
一直买京东的东西	正面	中性
一直在京东买东西	正面	中性
一直在就东购买产品	正面	中性
一直想买这款surface	正面	中性
不是不喜欢	正面	负面
不然哭死平板到时好平板	正面	中性
不负众望	正面	负面
不过单独运行CAD2016及Creo40也可	正面	中性
不过没啥影响最好配个蓝牙鼠标	正面	中性
不过至少不卡ps倒是无压力都不会卡	正面	负面
主要是物流问题	正面	负面
也没有感觉烫手	正面	负面
京东就是	正面	中性
京东第二天到货	正面	中性
今天早上就到了	正面	中性
从以前的苹果转到微软	正面	中性
会经常光顾这家店	正面	中性
但是作为本子	正面	中性
但是总算是少了一些有键盘盖有笔有笔尖很不错了~键盘盖没有味道~	正面	负面
但是看到保修期居然还有2年多	正面	负面
但是系统要多熟悉熟悉	正面	负面
但说是促销	正面	中性
体验简直不要更好	正面	负面
作为便携办公本使用体验还是很好的美中不足就是	正面	中性
做工100	正面	中性
先好评吧	正面	中性
刚用没多久就出大问题了	负面	正面
包装细致	正面	中性
单位采购一直是它	正面	中性
同事介绍购买的	中性	正面
外出临时画cad图只要一支笔加手触已经可以替代鼠标操作了	正面	负面
大家幸福平安	正面	中性
好评尤其是脸部识别	正面	中性
客服主动电话来问	正面	负面
就觉得只有SURFACE放在那里是个好东西	正面	中性
屏幕大	正面	负面
工业设计不必苹果的差	正面	负面
已经离不开了一刚巨硬大法好	正面	中性
希望能用起来给力	正面	中性
平板娱乐兼顾	正面	中性
平板模式看电影	正面	中性
幸亏没丢件	正面	负面
开始没细看包装清单	正面	中性
很轻很精致就是还没有用习惯	正面	负面
微软不是盖的	正面	中性
微软官方商店的软件不多	正面	中性
性价比高得不可想象	正面	负面
性能	正面	中性
总共用了不到十次京东这个质量我也无语了	正面	负面
手写是亮点	正面	负面
推荐别人买的	正面	中性
散热没有他们说的那么差	正面	负面
无漏光和坏点（没细查	正面	负面
早用早享受	正面	中性
是电源适配器的插口并不能与平板一起供电是说	正面	负面
更新最新版本win10后待机驱动等都没什么问题这个套装有带一支笔	正面	中性
服务也算是弥补了我前面的郁闷	正面	负面
服务是热情	正面	负面
期间升级win10系统N次直到最新版还是显示蓝牙鼠标已连接	正面	中性
没有任何问题只可惜预算有限	正面	负面
没有明显得风扇声	正面	负面
然后半小时不到立马退了100回来	正面	中性
然后有30天价保看外观没有二手痕迹	正面	负面
现在五千大洋能买到这样的电脑啊	正面	中性
用了一晚也没有发热现象	正面	负面
用起来不烫了	正面	负面
用起来更方便了我不玩游戏	正面	中性
电池方面	正面	中性
界面熟悉	正面	中性
目前也没有出现睡死现象至于以后怎样	正面	中性
目前没有发现差评里的那些情况	正面	中性
目前没有存在卡顿的情况	正面	中性
看着跟理想的区别不大就是笔还没玩	正面	中性
看视频一点也不卡	正面	负面
真是太好不过了	正面	负面
真的很好想像不到的好	正面	负面
磁吸充电口缺点	正面	负面
第二次购买surface电脑了	正面	中性
第二次购买了相当好用的二合一平板特别适合出差	正面	负面
老公买的相信他买的错不了	正面	负面
而且在环境昏暗的时候会有背照式灯光	正面	中性
自带OFFICE方便	正面	负面
虽然不如单纯的平板轻薄	正面	负面
要好好学习了	中性	正面
触摸板灵敏光滑触控笔有份量	正面	中性
记笔记都挺方便的特别适合出差办公	正面	中性
语音指示省去不少搜索输入	正面	中性
赶上促销终于出手	中性	正面
软件测试是新机	正面	负面
还带有屏幕触碰笔	正面	中性
还是键盘比较无敌	正面	负面
这也就意味着我不会买到二手货	正面	负面
重点要夸一下快递员	正面	中性
键盘手感都不行	负面	正面
11早上一看又变成12号送达客服人员还非常霸气得狡辩没有改送达时间	负面	中性
bug也特别多	负面	中性
一不小心就抢到了套装	负面	中性
不支持七天退换货就寄来一台旧电脑	负面	正面
不是十分够用	负面	正面
不知道是不是通病	负面	中性
不能买最新的下次再体验更高配的颜值	负面	正面
不能分区	负面	中性
不过也不算是最低价入手	负面	正面
不过我用的东西比较少基本没安装啥东西	负面	中性
不连接电源的情况下只用使用4个小时	负面	中性
主要竞争力没有发挥优势没有太惊艳	负面	正面
之前看到很多负面的评价	负面	正面
也不适合玩游戏	负面	中性
也是悲剧了	负面	正面
买亏了	负面	正面
买这玩意纯属钱多	负面	中性
京东的配送部门你们是这样粗暴对待客户的商品	负面	正面
京东真会为自己脸上贴金	负面	中性
人脸识别会经常出问题	负面	正面
人脸识别功能无法使用前面的我也忍了	负面	正面
今天准备评价的时候看到降价了100、	负面	中性
令人沮丧的开箱体验先开始Biao京东	负面	正面
以后不会再在京东买超过一百块的东西糟糕可恶	负面	正面
但性能中庸	负面	正面
但整套下来价格会比较高	负面	正面
但是下开试了一次马上秒删	负面	正面
但是你搜索东西跳转到第二个页面就出问题了刚买来的时候也是这样申请了维修	负面	中性
但是打开内包装	负面	中性
但是没什么用啊手机软件有办法用吗	负面	中性
但由于生活困难当了	负面	中性
但这次非常失望以后再也不会相信京东了	负面	正面
你丫的能不能弄个好点箱子	负面	中性
使用体验极差而且无法估计微软要到哪年才能修复这一BUG	负面	正面
使用便利性没有pad好	负面	正面
做工比苹果的还是差点	负面	正面
停产了优惠价	负面	正面
先是偶尔系统会死机	负面	中性
关键这个电脑我是送人的幸亏我检查一下准备帮人把软件都装好送人	负面	正面
出现了很多问题	负面	正面
到时候人生日都过去一星期了我还送个毛啊	负面	中性
办公用足够只是对有些软件的支持和优化还不到位	负面	正面
包装盒都裂了个口子然后开机激活	负面	中性
卡的问题我就不说了	负面	中性
又一次对京东失望	负面	正面
又打售后说配件硬件问题会给我换但是要等七到十五天	负面	中性
发生两次莫名其妙的蓝屏新买来的Surface	负面	中性
只能用两小时的样子更差的是锁屏了也一直在耗电	负面	中性
和预期有差异	负面	正面
唯一不方便的不知道怎么把它架起来	负面	中性
坚决抵制	负面	正面
多次承诺送货多次食言	负面	中性
大家要有耐心	负面	中性
大家谨慎购买	负面	正面
太恶心了	负面	正面
太恶心了吧	负面	正面
字小小的	负面	中性
字非常小	负面	正面
客服也都是你推给这里	负面	正面
客服和没有一样	负面	正面
客服更恶心	负面	正面
就是东哥你能送个膜么	负面	中性
就是平板模式电用好快	负面	正面
就是感觉很脆弱	负面	正面
就是没有送膜什么的	负面	中性
就算分区重装系统后也会影响非系统盘	负面	中性
希望不对使用造成影响	负面	中性
干嘛非用那么大的破箱子装那么小的电脑呢里面东西没有坏	负面	中性
平板状态玩纸牌都起热	负面	中性
应用商店仍是什么东西都没有键盘手感不错键盘上的触控板太小	负面	正面
开机电池没电	负面	中性
弄了好几次	负面	正面
得吐槽一下物流包装	负面	中性
微软一生黑	负面	正面
怎么让你麻烦就怎么做	负面	中性
想用来当主电脑用的慎重	负面	中性
我买了电脑回来还要我自己设置系统你们是干嘛的那我花钱干嘛呢电话指导维修了	负面	中性
我升完了比之前卡顿	负面	正面
我发现我好像对这Surface4的外壳过敏	负面	正面
我就是想知道买来第三天更新个系统就再也开不开机是怎么回事	负面	中性
我想问电脑被BitLocker锁定了一个多星期无解	负面	中性
我给摁进去有咔一声响第二天又有点翘起来了	负面	中性
所以产品定位其实有点模糊	负面	正面
所以没有7天无理由退换货	负面	中性
所以经常玩游戏的话最好还是买厚一些	负面	正面
才给我寄了键盘	负面	中性
打开没几分钟就开始发热了整体给75分吧	负面	正面
打微软客服竟然也无法解决	负面	正面
把劳资吓坏了啊来说说手感	负面	中性
把电充满用了也就2个小时	负面	中性
接口减少已经当主力机了	负面	正面
搜狗输入法第一个出问题	负面	正面
操作界面的字太小了出现过一次开机闪屏和杂音	负面	正面
改成11号送达但是没收到	负面	中性
故意把原价提高太多	负面	正面
显示未安装	负面	中性
更新了几次	负面	正面
最后只是教我备份重装系统看了网上	负面	中性
最好还是另买一个鼠标噢	负面	中性
最暗亮度会轻微闪屏	负面	正面
有时候不方便收件的时候	负面	中性
有时候不方便收件的时候	负面	中性
有点不足是用的时候有时会有风扇声	负面	中性
有点小不爽同样是京东自营	负面	中性
期待更新之后能减轻发热的问题	负面	正面
木有任何减震措施	负面	正面
机器一直短短续续有小问题用着再说吧	负面	中性
每次退出就自动刷新界面	负面	中性
比如惊奇的发现会卡	负面	正面
没有任何优点	负面	正面
没有充电	负面	中性
没有苹果的舒适度好	负面	正面
烂无比	负面	正面
然后噩梦就来了	负面	中性
然后开机键音量键手指轻放上去会四周晃动特别松动然后背后支架也是掰开松紧度不统一松一下紧一下	负面	中性
然后问在线客服	负面	中性
特别是触控笔至今用不来	负面	中性
特别是触控笔至今用不来	负面	中性
现在笔又要等两天售后安排上门取走	负面	中性
用材都比较考究	负面	正面
用鼠标调没问题不过也是爆cup的	负面	正面
电脑都打不开了起码你让我可以用到电脑基本功能啊	负面	正面
目前的显卡驱动和win10系统之间存在BUG	负面	中性
看pdf没有很好用的软件	负面	正面
看个电影看到一半就卡住了	负面	正面
看网页和打字还会卡一下是什么情况	负面	中性
真心不会玩主界面不会选看视频	负面	中性
磨坏裸屏）或许有什么隐藏功能未用到黑色键盘银色笔	负面	中性
竟然没有发键盘来	负面	中性
第一次升级半途停了	负面	中性
第一次碰上这么不走心的包装	负面	中性
第三方软件字体显示很模糊作为笔记本使用	负面	中性
系统停止	负面	中性
终于完成了系统的更新和注册	负面	正面
经过无数次的更新重启总算可以用了	负面	正面
虽然因为office没激活开始出了点小插曲	负面	中性
要买同类产品的千万别上京东买	负面	中性
触屏笔用了不到三个月不能启动inn功能	负面	中性
触控板现在还不要习惯用	负面	中性
让人头大恢复出厂设置	负面	正面
说好的能用十个小时呢两三个小时差不多	负面	中性
说真的只能给8分	负面	正面
还告诉我京东很多电子产品都是翻新机	负面	正面
还好这款只贵了一点	负面	正面
还是不能在应用商店下载东西	负面	中性
还未解决	负面	正面
还没适应过来	负面	中性
还烫得像铁板那样	负面	中性
这次买这个又是到手上边框有点翘边	负面	中性
这种比苹果差一个世纪	负面	正面
配合触控笔简直不要太方便	负面	正面
键盘索性就拿个塑料袋装了拿到手后	负面	中性
问问我不用电脑吗我买了电脑是玩的哈还不去去实体店买呢一堆问题	负面	正面
需重启系统	负面	中性
音亮滑一滑不了还有这些上下滑反页也不行例如酷狗搜索歌曲之后	负面	中性
颜值升级槽点	负面	正面
高分辨率的惊艳感不太强	负面	正面
高清线怎么还需要另买	负面	正面
黑色键盘比其他颜色看起来弱点	负面	正面
